 ### ### ############# ##### ####### ### 
#   #   #             #     #       #   #
# # # # ######### ### # ### ##### # ### #
# #   #         # #     # #       #     #
# ############# # ####### ############# #
#           #     #   #     #       #   #
# ######### ### ### # # # ### ##### # ## 
# #       #   # #   # # #     #   #   # #
# # ##### ### ### ### # ####### # ##### #
#   #   # # #       # #         # #O    #
 ###### # # ######### ########### ##### #
#       # #     #     #         # #   # #
# # ### # # ### # ##### ##### # # # # # #
# #   # #   #   # #   #     # # #   # # #
# ### # ### ##### # # ##### # # ##### # #
#   # #   # #     # #   #   # #     # # #
 ## # ### # # ##### ##### ### # ##### # #
# # # #   # #     #       # # # #     # #
# # # ##### ##### ####### # # ### ##### #
# # #     # #   #   #   #   #   # #     #
# # ##### # # ##### # # # ##### # # ### #
#   #   #   #     # # # # #   #   #   # #
# ### # ##### # # # ### ### # # ## ## # #
# #   #   #   # # #   #     # #   #   # #
# ##### # ##### ### # ####### ### # ### #
# #     #     # #   # #     #   #   #   #
# # ######### # # ##### ### ### ### #### 
#   #       # # #     # #     # #   #   #
 #### # ##### # ##### # # ### # ##### # #
# #   #     #       #   #   # #       # #
# # ####### ####### ####### ## ######## #
# #     # #       # #     #   #         #
# ##### # ####### # ##### ### # ######## 
# #   #     #   # # #   #   #   #       #
# # # ##### # # # # # # ### ######### # #
#   #     #   # # # # #           #   # #
# ### ######### # # # ########### # ### #
#   #         # #   # #     #     # # # #
 ## ##### ##### ##### # ### # ##### # # #
#       #             #   #         #   #
 ####### ############# ### ######### ### 
